단지: chỉ, duy chỉ/nhưng, chỉ có điều
인가: sự xác nhận, sự phê chuẩn
중시하다: xem trọng, coi trọng
속지주의: chủ nghĩa quốc gia phụ thuộc (hưởng quốc tịch của đất nước sở tại nơi bạn sinh ra và phải theo luật pháp của lãnh thổ sở tại bất kể bạn là người có quốc tịch nào).
속인주의: chủ nghĩa kế thừa (hưởng quốc tịch theo quốc tịch của cha mẹ dù được sinh ra tại bất kỳ quốc gia nào, và dù sống ở nước nào cũng phải tuân theo luật pháp của quốc gia bạn có quốc tịch)
혹은: hoặc, hay
분명하다: rõ ràng, chắc chắn
다만: chỉ, duy nhất, tuy nhiên 
본래: nguyên thủy, vốn có
행사하다: thực thi, thực hiện, dùng
서약: cam kết
정상적: tính bình thường
복수 국적자: nhiều quốc tịch, đa quốc tịch
이중국적: quốc tịch kép 
행위: hành vi
잃다: mất
의지: ý chị, nghi lực
유형: loại hình
지연: mối quan hệ đồng hương, láng giềng
성인: người trưởng thành
품행: phẩm hạnh
단정하다: đoan chính, đứng đắn
생계: sinh kế
기본소양: kiến thức cơ bản, trình độ cơ bản
입양되다: được nhận làm con nuôi
양자: con nuôi
공로: công lao
한하다: giới hạn, hạn chế
벨기에인: người Bỉ
고려인: người Cao Ly
공로자: người có công
수여하다: trao tặng, phong tặng
원장: viện trưởng
머물다: dừng chân
추기경: giáo chủ hồng y 
추천: sự tiến cử, sự đề cử 
판자촌: khu ổ chuột 
표창: sự biểu dương, sự khen tặng, bằng khen
수상하다: đạt giải, nhận thưởng
소재: sự có mặt, sự hiện diện 
재직하다: đương nhiệm, làm việc
보급교육: phổ cập giáo dục 
포장: huân chương , huy chương
훈장: huân chương 
국민훈장 목련장: huân chương quốc dân hoa Mộc Lan 