흐름: Dòng, mạch, dòng chảy
이래: trước nay, trước giờ, từ...
흘러오다: chảy xuống
연표: niên biểu
기원전: trước công nguyên
법전: bộ luật, điều lệ
반포: ban bố
건국: kiến quốc, lập nước
제정수립: thành lập chế độ đế vương (Chế độ chính trị của chủ nghĩa đế quốc)
서로마제국: đế quốc Tây La Mã
멸망: diệt vong
십자군: Thập Tự quân
개혁: cải cách
혁명: cuộc cách mạng
선언: tuyên ngôn, sự tuyên bố
등장하다: xuất hiện, ra mắt, ra đời
청동기: đồ đồng
만주: Mãn Châu
기원전: trước công nguyên
삼국유사: Tam Quốc Di Sự
다스리다: cai trị, thống trị
환웅: một nhân vật quan trọng trong nguồn gốc thần thoại của Hàn Quốc, đóng vai trò trung tâm trong câu chuyện của 단군, người sáng lập huyền thoại của 고조선, vương quốc đầu tiên của Hàn Quốc. 환웅 là con trai của 환인
이롭다: có lợi, có ích, giúp ích
홍익인간: nhân đạo, chủ nghĩa nhân đạo
품다: ôm, có
허락: sự cho phép
신하: hạ thần
무리: đám, bầy, sự quá mức....
이끌다: dẫn dắt. lãnh đạo
꼭대기: đỉnh, chóp
신단수: tên cây thiêng trong thần thoại 단군
빌다: cầu, cầu mong
쑥: rau ngải cứu
동굴: hang động
견디다: cầm cự, chịu đựng
뛰쳐나가다: lao ra, phóng ra
아사달: thủ đô của 고조선
도읍: đô ấp
엄격하다: nghiêm khắc
사형: tử hình, hành hình
처하다: rơi vào, bị kết tội, bị xử phạt
갚다: trả
노비: nô tì
삼다: lấy làm, dùng làm
죄를 용서받다: được tha tội