무속: đạo Shaman, tục cầu cúng
신앙: Tín ngưỡng
신령 : thần thánh
길흉화복: may rủi họa phúc
정하다: định, quyết định, chọn
무당 : pháp sư, thầy cúng, thầy bói
굿 : lễ trừ tà (của thầy bói)
점을 치다: xem bói
신: thần
존재: tồn tại, có thật
일상생활 : sinh hoạt đời thường, cuộc sống đời thường
행운 : vận may, số tốt
빌다: cầu mong, cầu khẩn
점을 보다 : coi bói, xin quẻ
역시 : quả là, quả thật
신성하다: thần thánh, linh thiêng
기운: sức lực, khí lức, số mệnh
마을입구 : đầu làng, cổng vào làng
지키다: bảo vệ, canh giữ
시골 : miền quê, vùng quê
제사 : sự cúng tế
빌다: cầu xin, cầu mong
장승: Cột bằng đá hoặc cây, được khắc mặt người và được đựng ở lối đi vào làng hoặc bên đường.
솟대 :  Là vật tượng trưng vừa biểu thị các vị thần giữ làng vừa biểu thị ranh giới của làng, trên đỉnh cột có gắn con chim bằng gỗ, được dựng ở cổng làng.
인식되다: được nhân thức
기둥 : cột, trụ
막대기: cây gậy
돌로 만든 새 : con chim làm bằng đá
올려놓다: để lên, đặt lên
행운 : vận may
세우다: dựng lên
불교: Phật giáo
기독교 : Cơ đốc giáo
유교: Nho giáo
원불교: Viên phật giáo
천도교: đạo Cheondo
이슬람교: Hồi giáo
인정하다: công nhận, thừa nhận
세기 : thế kỉ
무렵: vào lúc, vào khoảng, vào thời kì
전파되다: được truyền bá, được lan truyền
외래 : ngoại lai, du nhập ngoại
문화유산 : di sản văn hóa
탑: tháp
문화재 : tài sản văn hóa, di sản  văn hóa
지정되다: được công nhận, được chỉ định
삼국시대 : thời kỳ Tam Quốc
고려 : Cao Ly
통치 : sự thống trị
이념 : ý niệm, tư tưởng
채택되다: được lựa chọn, được tuyển chọn
영향을 끼치다: gây ảnh hưởng, tác động ảnh hưởng
웃어른 : người lớn, bề trên
예의 : lễ phép
결속 : sự đoàn kết, sự đồng lòng
따르다: tuân theo
가치관 : giá trị quan
인식되다: được nhận thức
제사를 지내다: cúng tế, cúng giỗ
가톨릭 : đạo Thiên Chúa (Catholic)
개신교 : đạo Tin Lành
서양 : phương Tây
신분 : vai trò, thân phận, địa vị, vị trí
평등: sự bình đẳng
주장하다: chủ trương, khẳng định
제사 : sự cúng tế
강조하다: nhấn mạnh, đề cao
억압 : áp bức, cưỡng bức
선교사: người truyền giáo
설립하다: sáng lập, thành lập, xây dựng nên
널리 알려지다: được biết đến rộng rãi
고유 : đặc trưng vốn có, cái vốn có
신도 : tín đồ
확보하다: đảm bảo 
이슬람 사원: tu viện Hồi giáo