국회 의사당: tòa nhà quốc hội
대학로: một khu phố ở Seoul phía bắc sông Hàn
속하다: thuộc về, thuộc loại
철새: chim di trú theo mùa 
생태적: mang tính sinh thái
측면: phương diện, khía cạnh
모래사장: bãi cát 
천연: thiên nhiên 
석회암: đá vôi 
종유석: thạch nhũ
석순: măng đá
어우러지다: hòa hợp
뽐내다: khoe, phô trương 
늪: bãi lầy, đầm lầy
자연사: lịch sử tự nhiên 
유유자적하다: sống an nhàn, sống thư thả, sống thư thái
풍요롭다: sung túc
가르다: phân định, phân chia
하천: sông ngòi, suối 
덮이다: bị che, bị phủ
갇히다: bị nhốt
복원: sự khôi phục, sự phục hồi 
다리: cây cầu
쉼터: nơi dừng chân, nơi nghỉ ngơi
발자취: dấu vết, dấu tích (cách nói ẩn dụ hàm ý quá trình đã qua trong quá khứ)
무형 문화제: văn hóa phi vật thể 
야간개장: mở cửa ban đêm
마감되다: được kết thúc, được hoàn thành 
엑스포: triển lãm quốc tế
박람회: hội chợ, hội triển lãm 
해돋이: mặt trời mọc, bình minh
머드: bùn 
탈춤: múa mặt nạ
춘향: Nhân vật nữ chính trong 'Xuân Hương truyện', là con gái của một kỹ nữ nàng đã vượt qua thân phận mình để vươn tới tình yêu với Lee Mong Ryong. 춘향 được vẽ ra như một người phụ nữ giữ vẹn tiết nghĩa.
꼬막: sò huyết
갈대: cây sậy 
해넘이: mặt trời mọc
해맞이: mặt trời lặn
조성하다: tạo dựng, tạo nên
주간: tuần, tuần lễ