취직하다: tìm được việc, có được việc làm
고자, để, để cho
실현하다: thực hiện
실업률, tỷ lệ thất nghiệp
선진국, nước phát triển, nước tiên tiến 
자영업: công việc tự kinh doanh, công việc tự quản lý
측면: phương diện, mặt
사회보장 제도, chế độ bảo đảm an sinh xã hội
치열하다: dữ dội, khốc liệt
차지하다: giành, chiếm hữu, chiếm giữ, nắm giữ
임금, tiền lương
노력을 기울이다: tập trung nỗ lực
생활수준, mức sinh hoạt, mức sống
열풍: cơn sốt (cách nói ẩn dụ)
줄임말, cách nói tắt, từ viết tắt
학벌: bằng cấp, trình độ học vấn
학점: điểm số, xếp loại
실무: nghiệp vụ thực tế, công việc nghiệp vụ
낫다: khá hơn, tốt hơn
인력, nhân lực
인정받다: được công nhận, được thừa nhận
지나치다: quá, thái quá
객관적, tính khách quan
지표, kiêm chỉ nam, tiêu chí, chỉ số
무시하다: coi thường
탐색하다: tìm hiểu, tìm kiếm
채용하다: tuyển dụng
눈여겨보다: để ý, lưu ý
적합하다: thích hợp
훨씬, rất, hơn hẳn
유리하다: có lợi
실무, công việc thực tế
경험을 쌓다: tích lũy kinh nghiệm
대우: đãi ngộ
업체: doanh nghiệp, công ty
부당한 대우: đối xử bất công
누리다: hưởng
관하다: liên quan đến
살펴보다: xem xét
고용노동부, Bộ lao động