횡단보도: lối sang đường cho người đi bộ
건너다: sang (đường)
쳐다보다: nhìn lên, nhìn thẳng, nhìn chằm chằm
달리다: chạy 
움직이다: chạy, chuyển động
뜻대로: theo ý muốn 
무질서: vô trật tự
혼란: sự hỗn loạn 
의하다: dựa vào, theo
공정하다: công bằng
손안: trong tay, trong tầm tay
확정일자: giấy xác nhận ngày
대처하다: ứng phó, giải quyết
직면하다: đối mặt, đối diện
법률서적: ấn phẩm luật, sách luật 
곤란하다: khó khăn, trở ngại 
법률분쟁: tranh chấp pháp lý 
이슈: vấn đề tranh cãi, vấn đề tranh luận
정의롭다: vì chính nghĩa, hợp đạo lý
정의: chính nghĩa
옳다: đúng đắn, chuẩn mực
그르다: sai trái
보상: sự đền đáp, sự trả công/ sự bồi thường 
저지르다: tạo ra, làm ra
혹은: hoặc, hay/ đôi khi
침해하다: xâm hại
침해당하다: bị xâm hại 
헌법소원: Nguyện vọng hiến pháp  
헌법재판소: tòa án hiến pháp
청구하다: yêu cầu
제시: sự đưa ra, sự đệ trình
지속적: tính liên tục 
여신상: tượng nữ thần 
대법원: tòa án tối cao 
추구하다: theo đuổi, mưu cầu
저울: cái cân
법전: bộ luật 
뜨다: mở (mắt)
잘잘못: đúng và sai, thị phi
올바르다: đúng đắn