구성되다: được tạo ra, được cấu thành
운영되다: được điều hành, được vận hành, hoạt động….
의무교육: giáo dục bắt buộc, nghĩa vụ giáo dục
취학: sự vào học
통지서: giấy thông báo
미루다: dời lại, hoãn lại
앞당기다: đổi (lịch hẹn lên sớm hơn), kéo ra trước, kéo đến gần
구분되다: được phân loại
교육청: sở giáo dục, phòng giáo dục
고려하다: cân nhắc, suy tính đến
배정하다: phân công, ấn định, phân định, bố trí…
희망자: người có nguyện vọng, người mong muốn
추첨 : sự bốc thăm, sự rút thăm
특수목적 중학교: trường trung học cơ sở năng khiểu
구분되다: được phân loại
두루: đồng đều, đều khắp
중점적: tính trọng tâm, mang tính trọng tâm
실시하다: thực thi, thi hành
고입선발고사: kỳ thi tuyển sinh vào trường cấp 3
치르다: trải qua
진학하다: học lên cao, học tiếp
입학시키다: cho nhập học
임대차 계약서: hợp đồng thuê nhà
주거사실 확인: xác nhận cư trú
절차: trình tự, thủ tục
거치다: đi qua, thông qua
교장: hiệu trưởng
가정통신문: bảng thông tin nhà trường gởi về gia đình
기록하다: ghi chép lại
알림장: sổ liên lạc
살펴보다: xem xét, soi xét, suy xét

학사학위: học vị cử nhân
특화: chuyên hóa, ưu tiên phát triển, tập trung mũi nhọn
출석하다: có mặt, hiện diện
성인: người lớn, người trưởng thành
장학금: học bổng
숙소: chỗ trọ
이루어지다: được thực hiện, đạt được, được tạo thành
구분되다: được phân, được phân loại
더욱: hơn, càng, càng ngày càng
전문가: chuyên gia
배출하다: sản sinh ra
대안학교: trường đề án, trường cải cách
입시위주 : chú trọng thi cử
보완하다: bổ sung, bổ khuyết, giải quyết
존재하다: tồn tại
특성화고, 특성화 고등학교: trường chuyên cấp 3
이르다: đạt đến
인정받다: được công nhận
별도: riêng biệt, riêng