호족: hào tộc, dòng tộc giàu có
세력: thế lực
등장하다: ra đời
견원: Kwon Hyeon - Vua lập nên nước 후백제 (Hậu Bách Tế)
궁예: .Gung Ye - Vua lập nên nước 후고구려 (Hậu Cao Câu Ly) (?~918) 
왕건: Cao Ly Thái Tổ, tên là Vương Kiến, trị vì từ năm 918 tới năm 943. Ông là vị vua đầu tiên đã thành lập nên triều đại 구려 (Cao Ly)
멸망시키다: làm diệt vong
진정하다: chân chính, thật sự
북진: sự Bắc tiến
추진하다: xúc tiến, đẩy tới
신분: thân phận
장신구: đồ trang sức
귀족: quý tộc
무신: quan võ
권력을 잡다: nắm quyền lực, nắm chính quyền
건축물: công trình kiến trúc  
석탑: tháp đá 
문화재: di sản văn hóa, tài sản văn hóa
주도하다: chủ đạo, cổ xướng
팔관회: một nghi thức cúng tế hướng về các thần linh ở thời 고려
침략: xâm lược
물리치다: đánh tan, đẩy lùi
넓히다: mở rộng
왜구: quân xâm lược Nhật 
홍건적: quân Khăn Đỏ
침입: xâm nhập
세력: thế lực
이성계: Lý Thành Quế - Thái tổ của Joseon
왕조: vương triều, triều đại
화약: thuốc nổ, thuốc súng
화통도감:  một tổ chức chịu trách nhiệm sản xuất thuốc súng và súng được thành lập bởi  최무선
잦다: thường hay
절감하다: thấu rõ, cảm nhận rõ
어렵사리: vất vả, khó nhọc
염초: một loại nguyên liệu để sản xuất thuốc súng
화약무기: vũ khí thuốc nổ, vũ khí thuốc súng
관청: cơ quan chính phủ, sảnh đường 
건의하다: kiến nghị, đề xuất
화포: hỏa pháo
척: chiếc (thuyền)
쳐들어오다: kéo tới
물리치다: đánh tan, đẩy lùi
무역항: cảng thương mại
드나들다: ra vào
공예품: hàng thủ công mỹ nghệ
고려청자: gốm sử xanh Cao Ly 
공예기술: kỹ thuật thủ công mỹ nghệ
고유하다: đặc trưng, đặc thù
특유: nét đặc hữu, nét đặc biệt
투명하다: sáng rõ, rõ ràng, trong suốt
부드럽다: mềm mại
생동감: sự sinh động, sự nổi trội
넘치다: tràn, đầy tràn, vượt mức 
활자: khuôn chữ, chữ in
금속: kim loại
활자본: bảng khắc chữ in (Sách sử dụng bản in làm bằng cách ghép các chữ in)
인쇄술: kỹ thuật in ấn
문화재: tài sản văn hóa, di sản văn hóa
목화: cây bông 
재배하다: trồng trọt, canh tác
안타깝다: xót thương, đau lòng
목화씨: hạt bông vải
들여오다: mang về, cầm về
수차례: nhiều lần, nhiều lượt
마침내: cuối cùng
임금: vua
섬기다: cung phụng, phục dịch
충신: trung thần
타락: sự thoái hóa, sự biến chất
집단: tập thể, nhóm
갈라지다: bị rạn, bị nứt 
제안하다: đề nghị, kiến nghị
거부하다: từ chối, khước từ
죽임을 당하다: bị giết chết
핏자국: vết máu 