공동주택: nhà cộng đồng, nhà chung cư, nhà tập thể
채: căn, tòa
차지하다: giành, chiếm, nắm giữ, chiếm hữu
다가구주택: nhà đa hộ, nhà nhiều hộ gia đình
소유권: quyền sở hữu
나머지: phần còn lại
세를 들다: thuê, mướn
연립주택: nhà tập thể
종종: thỉnh thoảng, đôi khi
차지하다: chiếm giữ
수백: hàng trăm
수천: hàng nghìn
무렵: khoảng thời kỳ, vào khoảng
으나: nhưng
선호하다: ưa chuộng, ưa thích
설계: sự thiết kế, việc lập kế hoạch
편의시설: tiện nghi
공공임대주택: nhà cộng đồng cho thuê
장기전세주택: nhà cho thuê dài hạn theo kiểu Jeonse
서민: dân thường
해당되다: tương ứng, tương xứng
시세: thời thế, thời cuộc, thời giá
자가: nhà riêng
맡기다: giao phó, phó thác
돌려받다: được hoàn lại, được trả lại
액수: số tiền
전입신고: đăng ký cư trú
확정일자: giấy xác nhận số ngày
훨씬: hơn hẳn, rất
비중: Tỷ trọng
혼합하다: pha trộn, trộn lẫn
방식: phương thức
공인 중개사: nhà mô giới được pháp luật công nhận
거래: sự giao dịch
등기부등본: bản sao công chứng giấy đăng ký
기록되다: được lưu giữ, được ghi chép
대법원: tòa án tối cao
등기소: sở đăng ký, nơi đăng ký
기준: tiêu chuẩn
방해하다: gây trở hại, cản trở
가리키다: chỉ, chỉ ra
상대적: tương đối
차량: lượng xe
인력: nhân lực
짐: hành lý, đồ đạc