가난: sự đói nghèo
불과하다: không quá
넘어서다: vượt qua
외환위기 : Khủng hoảng tiền tệ
금융: tài chính
위기: khủng hoảng
눈부시다: rực rỡ
가리키다: chỉ ra
비중: tỷ trọng
경공업: công nghiệp nhẹ
중화학 공업: công nghiệp hóa và công nghiệp nặng
제조업: ngành chế tạo sản xuất
선진국: nước tiên tiến, nước phát triển
생명 공학: công nghệ sinh học
정보 통신 : thông tin viễn thông
첨단: hiện đại, mới
자연 자원: tài nguyên thiên nhiên
자본: tài chính, vốn
활용하다: vận dụng, ứng dụng
수출: sự xuất khẩu
가발 : tóc giả
거치다: trải qua
철강 : thép
선박 : tàu thủy
반도체 : chất bán dẫn
석유 : dầu mỏ
겨우 : mới, một cách khó khăn
돌파하다: bưt phá
조 : nghìn tỷ
차지하다: chiếm giữ
요인: lý do chủ yếu, nguyên nhân chủ yếu
놀랍다: đáng kể, đáng ngạc nhiên, không ngờ
기대되다: được kỳ vọng, được mong chờ
확보: sự đảm bảo
추이: Diễn biến
수출액 : kim ngạch xuất khẩu
경제위기 : khủng hoảng kinh tế
해: sự tổn thất
거듭하다: liên tục, thường xuyên
차지하다: chiếm, nắm giữ