체류 자격 변경하다	Thay đổi tư cách cư trú
체류 자격	Tư cách cư trú
변경하다	Thay đổi
심사	sự kiểm tra, sự thẩm tra, sự điều tra
거치다	thông qua, trải qua
귀화 시험을 보다	thi kỳ thi quốc tịch
귀화 시험	kỳ thi nhập quốc tịch
기출문제	Đề thi đợt trước
요건을 갖추다	chuẩn bị các điều kiện cần thiết
요건 = 필요 조건	điều kiện, yêu cầu cần thiết
요건을 갖추다	thỏa mãn yêu cầu cần thiết
절차를 밟다	tiến hành các thủ tục (các khâu, trình tự)
심사에 통과하다	thông qua sự kiểm tra, thẩm duyệt
영주권을 받다	đạt được, nhận được quyền định cư
국적을 취득하다	nhập quốc tịch
국적을 변경하다	thay đổi quốc tịch
귀화허가신청서를 제출하다	đệ trình đơn xin cấp phép nhập quốc tịch
서류 심사	thẩm định hồ sơ
서류 심사를 통과하다	thông qua quá trình kiểm duyệt hồ sơ
면접 심사	thẩm tra phỏng vấn
면접 심사를 받다	nhận thẩm tra phỏng vấn
허가통지서	giấy thông báo chấp thuận
귀화 허가통지서를 받다	nhận thư (giấy) thông báo chấp thuận nhập quốc tịch
가족관계등록부를 신청하다	đăng ký khai báo quan hệ gia đình
포기하다	từ bỏ
외국 국적을 포기하다	Từ bỏ quốc tịch nước ngoài
주민등록증을 발급받다	được cấp phát chứng minh thư mới
반납하다	hoàn lại, trả lại
외국인등록증을 반납하다	Nộp lại, trả lại thẻ cư trú người nước ngoài
고충	Tình trạng khó khăn, tình huống phiền phức
의사소통에 어려움이 있다	gặp khó khăn về giao tiếp
국적이 없어서 불이익을 당하다	không có quốc tịch nên chịu nhiều bất lợi.
비자 연장을 해야 하다	Phải gia hạn Visa
피해를 받다	gặp (bị) tổn hại, bị thiệt hại