마땅히: một cách hiển nhiên, một cách xác đáng, một cách thích hợp
꼽다: vạch ra, đưa ra
민법: luật dân sự 
형법: luật hình sự 
다툼: sự tranh đấu
제시되다: được đưa ra, được cho thấy (được thể hiện bằng lời nói hay câu viết).
주장하다: chủ trương, khẳng định
사회질서: trật tự xã hội
형벌: hình phạt
정해지다: được quy định, được quyết định 
어기다: làm trái, vi phạm
저지르다: gây ra, phạm, mắc phải
죄: tội 
죄를 짓다: đắc tội, gây tội, mang tội
최종: cuối cùng, sau cùng
법관, 판사: thầm phán
양심: lương tâm
공정하다: công bằng
판결하다: phán quyết, tuyên án
민사재판: xét xử dân sự
유무: có hay không
형사재판: xét xử hình sự
검찰: cơ quan kiểm sát, công tố
거치다: thông qua
다툼: sự tranh đấu, sự tranh giành
억울하다: oan ức
가리키다: chỉ, chỉ ra
불공정: phi lý, không công bằng
지방법원: tòa án địa phương 
고등법원: tòa án cấp cao 
대법원: tòa án tối cao 
공정성: tính công bằng
확보하다: đảm bảo
단독부: ban hiệp ý
법집행기관: cơ quan thi hành luật
나서다: đứng ra
용의자: kẻ tình nghi
잡아들이다: bắt giữ
고소: sự tố cáo
위반: sự vi phạm 
판단되다: được phán đoán
처벌하다: xử phạt 
진압: trấn áp, cưỡng chế
수사: điều tra
단속: kiểm soát, trông coi
방지: phòng tránh, phòng ngừa
질서유지: duy trì trật tự
지구대: trạm cảnh sát 
집행하다: thi hành, thực thi
지휘하다: chỉ huy, chỉ đạo
청구하다: yêu cầu
권한: quyền hạn
의하다: dựa vào, theo, bởi
수행하다: hộ tống, thi hành, thực thi
권한을 부여 받다: được trao quyền