투표하다: bỏ phiếu, bầu cử
선거권: Quyền bầu cử
주어지다: được quy định
원칙: nguyên tắc
치러지다: tiến hành
추가되다: được bổ sung
후보: ứng cử viên, việc ứng cử
동등하다: đồng đẳng, ngang hàng
참정권: quyền tham chính, quyền bầu cử
국회의원: đại biểu quốc hội
영주권: quyền định cư
오르다: đưa vào (sổ sách)
납부하다: nộp, đóng
최초로: đầu tiên
영주권자: thường trú nhân, người có quyền định cư
지방선거투표권: quyền bỏ phiếu bầu cử địa phương
주민투표권: quyền bỏ phiếu cư dân
주민소환권: quyền triệu hồi cư dân
부여하다: ban, trao
지방자치제: Chế độ tự trị địa phương
도록 하다: cho, để cho, sai, bắt…
처하다: đối mặt
처리하다: xử lý
권력 남용: sự lạm quyền
지방의회: hội đồng địa phương
계획을 세우다: lên kế hoạch
실행하다: tiến hành
선출되다: được chọn
임기: nhiệm kỳ
최대: tối đa
특별시: thành phố đặc biệt, thủ đô
광역시: thành phố trực thuộc trung ương
사전투표: bỏ phiếu trước
설치되다: được thiết lập
가기: lúc thích hợp nhất