대학진학률: tỷ lệ học lên đại học
이루어지다: được tạo thành, được hình thành, được thực hiên, đạt được
진학하다: học lên cao, học tiếp
마치다: kết thúc, hoàn thành, chấm dứt, làm xong
이수: việc hoàn thành (chương trình học, khóa học, chương trình học)
졸업 예정자: người dự kiến tốt nghiệp
논술: Việc viết bài luật, việc đàm luận
거치다: thông qua, đi qua
경제협력 개발기구: tổ chức hợp tác và phát triển kinh tế 
최고: tốt nhất, cao nhất… 
수준: trình độ, tiêu chuẩn, mức tiêu chuẩn
달하다: đạt, đạt đến, đạt được
사회적 지위: địa vị xã hội
상승시키다: làm tăng lên, nâng lên
인식되다: được nhận thức
임금: tiền lương
영향: sự ảnh hưởng
전문대: trường cao đẳng nghề
집계되다: được tính tổng, được tổng cộng, được thống kê
학력별: theo học lực
나타나다: thể hiện, bộc lộ, phô bày, xuất hiện
사회적인 지위: địa vị xã hội
유리하다: có lợi
경쟁: sự cạnh tranh
치열하다: dữ dội, khốc liệt
벌어지다: xảy ra, diễn ra, nổ ra (chủ yếu những việc không tốt)
기꺼이: vui lòng, hân hoan
엿: kẹo kéo, kẹo mạch nha
찹쌀떡: bánh bột nếp
붙다: dính, đỗ, đậu
찍다: bấm (lỗ), đâm, xỉa
풀다: tháo, cởi, mở
교육열: nhiệt huyết giáo dục, sự hiếu học
우수하다: ưu tú, vượt trội
인재: nhân tài
길러내다: đào tạo
이바지하다: cống hiến, đóng góp
궁극적: tính cuối cùng
영향을 끼치다: gây ảnh hưởng
지나치다: quá, thái quá
인하다: do, bởi, tại
사교육비: tiền học thêm
과외: sự dạy thêm, sự học thêm
사교육: giáo dục tư, sự dạy tư, sự học tư
상당하다: khá nhiều, tương đối, tương đương…
대학 입시: kì thi tuyển sinh đại học
더욱: hơn nữa, càng…
입시지옥: địa ngục trần gian kỳ thi tuyển sinh
인식되다: được nhận thức
시달리다: đau khổ, khổ sở
영향을 끼치다: gây ảnh hưởng
조기: thời kỳ đầu, sớm
돈을 벌다: kiếm tiền
열풍: cơn sốt
증가: sự gia tăng