모임	Hội họp	
예시	Ví dụ minh họa	
모임	Hội họp	
예시	Ví dụ minh họa	
송년회	Tiệc tất niên, liên hoan cuối năm	
연말에 송년회를 하다	Làm tiệc tất niên vào cuối năm	
시무식	Tiệc đầu năm, buổi họp mặt đầu năm	
연초에 시무식을 하다	Họp mặt gặp gỡ đầu năm	
송별회	Tiệc chia tay	
떠나는 친구를 위한 송별회를 열다	Mở tiệc chia tay dành cho ngời bạn rời đi	
야유회	Buổi dã ngoại	
교외로 야유회를 가다		Đi dã ngoại về vùng ngoại ô	
동창회	Hội đồng môn, hội bạn học cùng trường	
대학 동창회에 나가다.	Đến hội đồng môn trường đại học	
동호회	Hội những người cùng sở thích	
등산 동호회에 들다	Vào hội những người cùng yêu thích leo núi	
OO연합회	Liên hiệp, liên đoàn, hội liên hợp OO	
연합회에 가입하다	Gia nhập liên hiệp/ hiệp hội	
학부모회	Hội phụ huynh	
학교 학부모회에 참석하다	Tham dự hội phụ huynh trường	
반상회	Họp tổ dân phố, họp khu phố	
매달 반상회에 참여하다	Tham dự buổi họp tổ dân phố hàng tháng	
부녀회	Hội phụ nữ	
아파트 부녀회 회원이 되다	Trở thành hội viên hội phụ nữ chung cư		
가족 모임	Họp mặt gia đình, cuộc họp gia đình	
가족 모임을 가지다	Có buổi họp mặt gia đình	
부부 동반 모임	Buổi hội họp các cặp vợ chồng 	
부부 동반으로 모임에 참석하다	Tham gia buổi tụ họp của các cặp vợ chồng
정기 총회	Đại hội định kì, hộp họp định kì
송년회 식순	Chương trình lễ tất niên, trình tự nghi thức buổi liên hoan cuối năm
개회사	Diễn văn khai mạc
귀빈 소개 및 축사:Giới thiệu khách mời danh dự và lời chúc mừng
회장 인사말	Lời chào của chủ tịch/ hội trưởng
축가	Bài hát chúc mừng
건배사 및 식사	Sự nâng ly chúc mừng và ăn uống
안내 사항 공지	Thông báo/ công bố các thông tin/ sự kiện/ vấn đề
폐회사	Diễn văn bế mạc
송년회	Liên hoan cuối năm
부부 동반	Vợ chồng đi cùng, vợ chồng cùng đồng hành
처음	Lần đầu
긴장하다	Căng thẳng
분위기	Bầu không khí
편안하다	Thoải mái, bình an, thanh thản
쌍	Cặp đôi
그동안	Thời gian qua
나누다	Chia ra, phân chia
떠나다	Rời khỏi, rời xa
익숙하다	Quen thuộc, thân thuộc
소중하다	Quý báu, quan trọng
마련하다	Chuẩn bị
더라도	Cho dù, mặc dù
내외분	Vợ chồng
빛내다	Làm rạng rỡ.
희망차다	Đầy kì vọng, đầy hi vọng
맞이하다	Đón tiếp
-도록	Để, sao cho
격려하다	Động viên, cổ vũ, khích lệ
기원하다	Cầu mong, mong ước
단순히	một cách đơn thuần
상사	cấp trên
업무	nghiệp vụ, công việc
연장	công cụ, dụng cụ/ sự tăng cường thêm, sự tiếp nối
인식되다	được nhận thức
단합하다	đoàn kết, hòa hợp
지나치다	quá, thái quá
손실	sự tổn thất
적당하다	hợp lý, vừa phải, thích hợp
특유	nét đặc trưng, sự đặc hữu, sự sở hữu đặc biệt
조직	cơ cấu tổ chức, việc tổ chức
형성	sự hình thành
긍정적	tính tích cực
영향을 끼치다	gây ảnh hưởng, tác động
입장	lập trường/ sự vào cửa
술자리	bàn rượu, bàn nhậu, chỗ nhậu, nơi nhậu
이어지다	tiếp tục, được nối tiếp, được tiếp diễn
낯설다	Lạ lẫm, xa lạ, lạ mặt
광경	quang cảnh
건전하다	tích cực, lành mạnh