출생률	tỷ lệ sinh
태어나다	sinh ra, được sinh ra
출생하다	sinh ra, ra đời
자라다	phát triển, lớn lên
성장하다	trưởng thành
고령화	Sự già hóa
나이를 먹다	già đi, có tuổi, thêm tuổi
늙다	già, già đi
사망률	tỷ lệ tử vong
죽다	chết
사망하다	tử vong, qua đời, chết
출산율	tỷ lệ sinh đẻ (sinh sản)
낳다	sinh nở
출산하다	sinh nở, sinh đẻ, sinh sản
키우다	nuôi nấng, nuôi dưỡng
양육하다	dưỡng dục, nuôi lớn
높다	cao, lớn
낮다	thấp, nhỏ
늘다	tăng lên
줄다	giảm đi
증가하다	tăng lên, gia tăng
감소하다	giảm đi, giảm bớt
유아	trẻ sơ sinh, trẻ nhỏ
아동	nhi đồng, thiếu nhi
청소년	thanh thiếu niên
성인	vị thành niên
청년층	trưởng thành, thanh niên
장년층	trung niên
노년층	người cao tuổi, cao niên, lão niên
비율	tỷ lệ, tỷ số, phần trăm
추이	sự thay đổi/ change; shift; transition
고령화	già hóa dân số
전망	Sự nhìn xa, tiên đoán



시급히	một cách gấp rút, một cách cấp bách
개교하다	thành lập trường
저출산	sự sinh ít con, hiện tượng sinh ít con
전교생	học sinh toàn trường
불과하다	bất quá, không quá, không hơn
강당	giảng đường
빼곡히	kín mít, chật ních
메우다	lấp đầy, đổ đầy, bịt kín
노인 복지관	viện phúc lợi dành cho người cao tuổi
당시	lúc đó, thời đó, đương thời
고령화	sự già hóa
출산율	tỷ lệ sinh
꾸준히	đều đặn
반면	ngược lại, trái lại
급격히	một cách đột ngột
앞지르다	qua mặt, vượt qua, chiếm trước, giành trước
결국	kết cục
부양하다	chu cấp, cấp dưỡng
숙련되다	trở nên điêu luyện, trở nên nhuần nhuyễn
노동력	sức lao động
활용하다	vận dụng, ứng dụng
출산 장려 정책	chính sách khuyến khích sinh đẻ
연계하다	kết nối, gắn kết, buộc, hợp tác, kết hợp
돌보다	chăm sóc, săn sóc, trông coi



저출산	hiện tượng ít sinh con
부담스럽다	đầy gánh năng, nặng nề, đáng ngại
재정적	mang tính tài chính
재정적 지원	hỗ trợ tài chính
개인주의	chủ nghĩa cá nhân, tư tưởng cá nhân
확산되다	được mở rộng, được phát triển, lan rộng
얽매이다	bị vây hãm, bị trói buộc
해결하다	giải quyết
지원을 아끼지 않다	không tiếc chi viện, không ngại hỗ trợ



저출산	Sự sinh ít con, hiện tượng sinh ít con
혜택	Sự ưu đãi, sự ưu tiên, sự đãi ngộ
시행되다	Được thi hành, có hiệu lực
선택하다	Chọn lựa, chọn lọc
책정되다	Được xác định
지자체	 chính quyền địa phương, tổ chức tự trị địa phương