아파트 관리사무실에서	Ở văn phòng quản lý chung cư
회사 홍보부에서	Ở bộ phận quảng bá công ty (bộ phận PR)
알려 드리다 (알리다)	Đưa ra các thông báo, truyền tin
새로운 인재	Nhân tài mới, tài năng mới
관심 있는 분들	Những người quan tâm
모시다	Đưa đón, hướng dẫn, đón rước
생일잔치에	Ở bữa tiệc sinh nhật
크리스마스 파티에	Ở tiệc giáng sinh
초대하다	Mời
동호회회원	Thành viên hội những người cùng sở thích
자원봉사자	Tình nguyện viên
모집하다	Chiêu mộ, tuyển sinh
행사	Sự kiện, buổi lễ, sự tiến hành
대회	Đại hội
열리다	Được mở ra
청첩장	Thiệp mời cưới
개업 안내	Thông báo lễ khai trương
초대장	Thư mời
부고	Cáo phó 
접수	Sự tiếp nhận, sự thu nhận
경력	Kinh nghiệm
장기자랑	Buổi trình diễn tài năng
청첩장	Thiệp mời cưới
잠깐	Thời gian ngắn, một lát, một chốc
용건	Việc, chuyện, việc cần làm, điều cần nói
다름이 아니라	Không gì khác mà là, không có lý do nào khác mà là…
현장 체험 학습	Việc học ngoại khóa
대하다	Về (cái gì đó, ai đó…)
고요	Sự yên tĩnh
수목원	Vườn thực vật
단체	Tổ chức, đoàn thể, nhóm
주문하다	Đặt hàng
개인적	Mang tính cá nhân
반	Ban, lớp
궁금하다	Tò mò, băn khoăn, thắc mắc
홈페이지	Trang chủ, trang web
게시판	Bảng thông báo
기능 tính năng
동시 đồng thời, cùng lúc
채팅 chatting