충족하다: thỏa mãn, đáp ứng
필연적: tính tất yếu 
한정되다: có hạn, bị giới hạn
어촌: ngư thôn, làng chài
촌락: làng quê, thôn xóm
상대적: tính tương đối
자연 재해: thiên tai
복구: sự phục hồi, sự khắc phục
이기심: lòng ích kỷ 
태우다: đốt
혐오시설: công trình người dân không muốn đưa vào khu họ ở (bãi xử lý rác...)
혐오시설: công trình người dân muốn đưa vào khu họ ở (trường, công viên, ga tàu...)
타협: sự thỏa hiệp 
지혜롭다: thông minh, sáng suốt
풀어내다: tháo gỡ, giải tỏa
님비 (NIMBY = Not In My Backyard): hiện tượng người dân phản đối một dự án công trình nào đó chủ yếu bởi vì nó sẽ được xây dựng gần nơi họ sinh sống. Những công dân này thường thấy sự cần thiết của dự án đó nhưng phản đối nó vì những tác động tiêu cực đến họ.
광역폐기물처리시설: công trình xử lý rác thải quy mô lớn
논의: việc bàn luận
험난하다: hiểm trở, khó khăn, khó nhọc
차례:lượt 
견학하다: đi kiến tập, đi thực tế
수차례: nhiều lần
거치다: trải qua
총회: cuộc họp, đại hội
찬성: sự tán thành, sự đồng tình
긍정적: tính tích cực
꼽히다: được xếp vào, thuộc vào 
시민단체: đoàn thể thành thị (tổ chức không vụ lợi do người dân thành thị tự thành lập và hoạt động tình nguyện hoặc tham gia cứu hộ vì lợi ích chung).
언론: ngôn luận
매체: phương tiện
여론: dư luận 
형성하다: hình thành
공감: sự đồng cảm 
배려: sự quan tâm giúp đỡ
떠오르다: nổi lên
유도하다: dẫn dắt 
가해자: người gây hại
타협: thỏa hiệp 
도달하다: đạt được
다문화 서포터즈단: tạm dịch là tổ chức hỗ trợ đa văn hóa 
손잡다: bắt tay, hợp tác
벌이다: bắt đầu, khởi xướng, mở
결의: sự quyết tâm, sự cương quyết
구간: đoạn, khúc, khu vực 
리플릿: tờ rơi
배부: phân phát 
골목길: hẻm 
펼치다: bày ra, mở ra, tổ chức
창단되다: được sáng lập
힘쓰다: cố gắng nỗ lực, cố gắng hết sức