출산: Sự sinh con, sự sinh đẻ
보육: sự nuôi dưỡng, sự nuôi dạy
장려하다: khuyến khích, động viên
국가바우처사업: dự án voucher quốc gia
국민행복카드: thẻ công dân hạnh phúc
일부: một phần
지원한다: hỗ trợ, chi viện
별도: riêng biệt, riêng
각: mỗi, từng
별로: theo, cá biệt, riêng biệt, riêng lẻ, đặc biệt
장려금: tiền khuyến khích
상세하다: chi tiết, cặn kẽ
사항: điều khoản, thông tin
문의하다: hỏi, tư vấn
영아: trẻ sơ sinh, trẻ nhỏ đang bú mẹ (0 đến 2 tuổi)
유아: trẻ ít tuổi chưa đi học (3 đến 5 tuổi)
영·유아: trẻ dưới 6 tuổi
유형: loại hình
어린이집: nhà trẻ, trường mầm non (0 đến 5 tuổi)
유치원: trường mẫu giáo (3 đến 5 tuổi)
취학: sự vào học
미만: dưới, chưa đến
양육수당: phụ cấp nuôi dưỡng
지급되다: được chi trả, được cấp
재산: tài sản
절차: trình tự, thủ tục
제출: nộp, đệ trình
수령 : lĩnh, lãnh, nhận
지정하다: chỉ định
요양기관: cơ quan điều dưỡng 
담당하다: đảm đương, đảm trách, đảm nhiệm
설립하다: thiết lập, thành lập
국·공립: quốc lập. công lập
사립: dân lập, tư nhân
민간인: người dân, dân thường
교회: giáo hội, nhà thờ (đạo Tin Lành)
성당: thánh đường, nhà thờ (đạo Thiên Chúa Giáo)
종교: tôn giáo
세우다: xây dựng, thành lập
돌보다: chăm sóc, săn sóc, trông coi
운영되다: được vận hành, được điều hành
종일 : cả ngày
중요성: tính quan trọng
더욱: hơn nữa, ngày càng…
높아지다: trở nên cao hơn