이익: Lợi ích
주장: sự chủ trương
표출하다: biểu lộ, thể hiện
펼치다: bày ra, mở ra, tạo nên, mở rộng, thể hiện
갈등: sự mâu thuẫn
불가피하다: không tránh được, bất khả kháng
제대로: một cách bài bản, một cách tử tế
혼란스럽다: hỗn loạn
수많다: vô số
피해를 입다: bị thiệt hại
받아들이다: tiếp nhận
조정하다: điều chỉnh
일상적: mang tính thường nhật
정치인: chính trị gia
상대로: chống lại, đối đầu
주장: chủ trương
실현하다: thực hiện
나서다: đứng ra, xen vào
귀를 기울이다: lắng nghe
지혜: trí tuệ
구성원: thành viên
떠오르다: nổi lên
층간소음: tiếng ồn giữa tầng
분쟁: sự phân tranh
해소: sự hủy bỏ
중재하다: hòa giải
상충되다: bị xung khắc
이해관계: quan hệ lợi hại, quan hệ lợi ích
꼽히다: thuộc vào, được xếp vào
다툼: sự cãi nhau, sự tranh đấu
불만: sự bất mãn
제기되다: được nêu ra, được đề xuất
규정: quy định
측정하다: đo lường
매트 설치: Lặp đặt tấm thảm nệm
슬리퍼 착용: mang dép đi trong nhà
자제: sự kìm chế, sự tự chủ
제시하다: đưa ra, nộp
관계자: người có liên quan, người có phận sự
불리다: bị gọi, được gọi
대변하다: nói thay, đại diện phát ngôn
정당: chính đảng
출마하다: ra ứng cử
집회: cuộc mít ting, cuộc tụ hội
시위: sự biểu tình
주장: chủ trương
거리 행진: diễu hành trên phố
촛불 집회: biểu tình nến
온건하다: ôn hòa
접하다: tiếp nhận, tiếp cận
활용하다: vận dụng, ứng dụng
추가: sự bổ sung
설치하다: thiết lập, lắp đặt
위치하다: tọa lạc, năm ở vị trí
오가다: qua lại
신체: thân thể, cơ thể người
운반하다: vận chuyển, chở
결성되다: được thành lập
기자회견: họp báo
필요성: tính thiết yếu
받아들이다: tiếp nhận, tiếp thu
추가: bổ sung
약자: người yếu, kẻ yếu
강화하다: tăng cường
밝히다: làm rõ