거래하다: giao dịch
시중은행: ngân hàng thương mại
맡기다: gửi, ủy thác ký gởi, giao, giao phó
설치되다: được thiết lập, được lắp đặt
자금: tiền vốn, tiền quỹ
광역시: thành phố trực thuộc trung ương, thành phố lớn
예금: sự gửi tiền, tiền gửi
금리: lãi, lãi suất
본인: chính bản thân, đương sự
금융: tài chính tiền tệ
금융 실명제: chế độ giao dịch tài chính bằng tên thật
처벌을 받다: Nhận sự trừng phạt, hình phạt.
현금인출기: máy rút tiền tự động
송금: sự chuyển tiền
저축: sự tiết kiệm, tiền tiết kiệm, quỹ tiết kiệm
정기: định kỳ, có thời hạn
정기적금 : tiết kiệm kỳ hạn
정기예금: tiền gửi có kỳ hạn
금액: số tiền
횟수: số lần
원금: tiền gốc, vốn
이자: tiền lời, tiền lãi
한꺼번에: một lượt, tất cả cùng một lần
예금하다: gửi tiền
대체로: nói chung
맡기다: giao, gửi
-짜리: mệnh giá, loại
해지하다: hủy
이익: lợi ích, lãi
주식: cổ phần
채권: trái phiếu, trái khoán, chứng khoán
본래: vốn, căn bản
돌려받다: được trả lại, được hoàn lại
질병: bệnh tật
기능: tính năng, kỹ năng
부실하다: yếu kém
망하다: sụp đỗ, tan rã.
원금과 이자: tiền gốc và tiền lãi
합치다: gộp lại
보장하다: bảo đảm
새마을금고 : quỹ tiết kiệm 새마을
업계: ngành, giới
자체적: tính chất tự mình, tính chất tự nó, tự bản thân
기금: tiền quỹ
적립하다: tích lũy, tích trữ