평생교육: giáo dục thường xuyên
요구하다: yêu cầu
지식: kiến thức, tri thức
얻다: nhận được, có được
마치다: kết thúc, hoàn thành, chấm dứt
취향: khuynh hướng, sở thích
늘어나다: tăng lên
본인: chính bản thân 
지속적: tính liên tục 
이루어지다: được tạo thành, đạt được…
글자 그대로: theo như mặt chữ 
평생: cuộc đời 
운영하다: vận hành, điều hành, hoạt động
전문가: chuyên gia 
자격증 : chứng chỉ, giấy chứng nhận 
구민회관: hội quán quận, nhà văn hóa quận 
구성되다: được tạo ra, được cấu thành, được bao gồm
강좌: lớp học, khóa học 
맞추다: điều chỉnh, làm cho phù hợp
노년층 : tầng lớp người cao tuổi
원격: từ xa, khoảng cách xa 
동영상자료: tài liệu video
자연스럽게: một cách tự nhiên
동화: đồng thoại, truyện cổ tích
점차: dần dần, từ từ
이수하다: hoàn thành, kết thúc
취득하다: có được, lấy được
혜택: sự ưu tiên, sự ưu đãi  
고용노동부: bộ lao động và việc làm 
위탁: sự ủy thác 
민간단체: tổ chức phi chính phủ, tổ chức tư nhân, đoàn thể nhân dân
이중 언어 : song ngữ
제과: làm bánh kẹo 
제빵 : làm bánh mì
바리스타 : pha chế đồ uống (Barista)
풍선아트: làm bóng bay nghệ thuật (Baloon art)
네일아트: Vẽ móng (Nail art)  
원어민 강사: giảng viên bản ngữ 