닌간다운 삶: Cuộc sống đúng nghĩa
누리다: Tận hưởng
공공부조: Trợ cấp công cộng, hỗ trợ công cộng
대비하다: So sánh, đối phó, phòng bị
상황: Tình hình, tình huống, hoàn cảnh
건강보험: Bảo hiểm sức khỏe,
고용보험: Bảo hiểm thất nghiệp,
국민연금: Trợ cấp hưu trí
산업재해보상보험: Bảo hiểm bồi thường tai nạn lao động 
해고되다: Bị sa thải, bị đuổi việc
금전적: Mang tính tiền bạc
보상받다: Được bồi thường
지방자치단체: Chính quyền địa phương
최저생계비: Phí sinh hoạt tối thiểu
금전적: Mang tính tiền bạc
한부모가정복지: Phúc lợi cho gia đình có bố mẹ đơn thân
재활: Sự phục hồi chức năng/ hoạt động trở lại
직업 훈련: Huấn luyện nghề, dạy nghề
질병: bệnh tật
부상: bị thương
이바지하다: đóng góp, cống hiến
증진: tăng cường
창업: khởi nghiệp
촉진: sự thúc đẩy, sự xúc tiến
업무상 재해를 입다: bị tai nạn nghề nghiệp
해당하다: Phù hợp, thỏa mãn
혜택: Sự ưu đãi, sự đãi ngộ 
미성년: Tuổi vị thành niên
앞두다: Trước, đứng trước
산모: Sản phụ
학업: Việc học
법무부: bộ tư pháp
운영하다: vận hành , điều hành, hoạt động
여성가족부: Bộ bình đẳng giới
이주여성긴급지원센터 : trung tâm hỗ trợ khẩn cấp phụ nữ nhập cư