피해를 입다: bị thiệt hại
정당하다: chính đáng
문서: tài liệu, tư liệu
차용증: chứng từ vay mượn, giấy vay nợ
이자: tiền lãi 
갚다: trả
살펴보다: xem xét
부동산의 등기부등본: bản sao công chứng giấy đăng ký bất động sản 
활용하다: tận dụng, ứng dụng, sử dụng
계약을 맺다: ký hợp đồng
법무사: chuyên viên tư vấn luật
대신하다: thay thế
공인 중개사: người mô giới được công nhận tư cách pháp lý
소유하다: sở hữu
종료하다: kết thúc, chấm dứt
의사: ý định, ý nghĩ
세 들어 살다: thuê nhà
효력: hiệu lực
합리적으로: một cách hợp lý
인정받다: được công nhận
거부하다: từ chối, khước từ
정신적: tính tinh thần
육체적: tính thể chất 
의지하다: tựa vào, nhờ vả vào
벌어들이다: kiếm về
가사노동: việc nhà 
양측: hai bên
부정하다: ngoại tình
제대로: đúng mực 
이행하다: thực hiện
강제로: bằng cưỡng chế 
위자료: tiền bồi thường
당사자: đương sự, người có liên quan
범위: phạm vi, giới hạn 
허용된다: đương chấp nhân, được thừa nhận