소속: thuộc về
머무르다: lưu lại, dừng lại
단기: ngắn hạn
장기: dài hạn
머물다: ở lại, dừng chân
떠나다: rời khỏi
초과하다: quá, vượt quá
관할: thẩm quyền, phạm vi quyền hạn
전입하다: chuyển tới
재외동포: đồng bào nước ngoài
소지자: người sở hữu
첨단산업분야: lĩnh vực công nghiệp hiện đại
법률: pháp luật, quy định của pháp luật
용어: từ chuyên ngành, thuật ngữ chuyên môn
사증: thị thực
조약: thỏa thuận, hiệp ước
누리다: hưởng
마찬가지: giống nhau
추구하다: mưu cầu, theo đuổi
근로기준법: luật về tiêu chuẩn lao động
동등하다: ngang hàng, đồng đẳng
의하다: dựa vào, theo
적절하다: thích hợp, thích đáng
고용허가제: chương trình cấp phép việc làm, chế độ cho phép sử dụng lao động
이행하다: thực hiện, thực thi
유엔아동 권리협약: công ước Liên Hợp Quốc (UN) về quyền trẻ em
신체적: mặt thân thể, mặt thể xác
재결합: sự tái hợp, sự đoàn tụ
차별: phân biệt, kỳ thị
착취: sự bóc lột