정해지다: được quy định
정기적: tính định kì, có tính chất định kì
정기시장: chợ phiên
여전히: vẫn, vẫn còn, vẫn như xưa (giống như trước đây)
단지: khu
특정하다: riêng biệt, cá biệt
장터: chợ, khu chợ
신선하다: tươi
해당하다: phù hợp, tương ứng
상인: thương nhân, thương lái, nhà buôn
인심: nhân tâm, lòng người
몰리다: đổ xô
붐비다: tấp nập, đông nghịt, chật ních
흥정하다: mặc cả, trả giá
공산품: sản phẩm công nghiệp
한꺼번에: một lượt, một lần
정찰제: giá niêm yết, chế độ bảng giá
참고하다: tham khảo
살펴보다: xem xét, suy xét
부가가치세: thuế giá trị gia tăng (VAT)
세금: tiền thuế
세율: thuế suất
가격표: bảng giá, tem giá
덜다: giảm, khấu trừ
국세청: tổng cục thuế
피해를 입다: bị thiệt hại
정당하다: thỏa đáng, chính đáng
교환: đổi hàng
환불: trả hàng, hoàn tiền
보상: việc bồi thường
권리를 주장하다: đòi quyền lợi
누리다: hưởng, được
상점: tiệm bán hàng, cửa hàng
만약: giả sử
한국소비자원: Tổ chức người tiêu dùng Hàn Quốc
국번없이: không cần mã vùng
구제: sự cứu tế, sự cứu trợ, sự giúp đỡ
건전하다: tích cực, lành mạnh
스스로: tự mình, tự thân
살피다: soi xét, xem xét, suy xét
생산자: nhà máy, người sản xuất
책임을 지다: chịu trách nhiệm
마련하다: chuẩn bị, sắp xếp
어기다: làm trái, vi phạm
제기하다: đề xuất, nêu ra, đưa ra
사례: ví dụ cụ thể, ví dụ điển hình
표시하다: biểu hiện, biểu thị, biểu lộ
유통되다: lưu thông
제조업체: công ty sản xuất
리콜: (recall) sự thu hồi (sản phẩm)