이해관계: quan hệ lợi hại, quan hệ lợi ích
조정하다: điều chỉnh, dàn xếp
통치하다: thống trị
좁히다: thu hẹp
이롭다: có lợi, tốt cho, có ích cho
헌법: hiến pháp
공화국: đất nước cộng hòa
밝히다: làm rõ
주권: chủ quyền
권리: quyền lợi
행사하다: thực thi, thực hiện
인간: con người
존엄성: tính tôn nghiêm
평등: bình đẳng
하여금: một cách bắt buộc
도록 하다: cho, sai, bắt, làm cho…
채택하다: lựa chọn, tuyển chọn
국민투표: trưng cầu ý dân
부분적: mang tính bộ phận, một phần…
역대: nhiều đời, các đời
선출하다: lựa chọn, bầu cử
이끌다: lãnh đạo, dẫn dắt
제정: sự ban hành
혁명: cuộc cách mạng
민주화운동: phong trào dân chủ hóa, cuộc vận động dân chủ hóa
항쟁: sự đấu tranh, cuộc kháng chiến
광복: giành lại được chủ quyền
총선거: tổng tuyển cử
제헌국회: quốc hội lập hiến
제헌절: Ngày Lập Hiến (17.07)
제정하다: ban hành, quy định
초대: đời đầu, thế hệ đầu
선출되다: được bầu chọn
수립되다: được thành lập
당시: lúc đó, đương thời
여당: đảng cầm quyền
정권: chính quyền
장기: trường kỳ
집권: sự cầm quyền
국회의원: đại biểu quốc hội, ủy viên quốc hội
개표: kiểm phiếu
조작하다: ngụy tạo
반발하다: phản kháng, chống đối
시위: thị uy, biểu tình
물러나다: rút khỏi
정착: sự định cư, bám rễ, gắn chặt
의의를 지니다: mang ý nghĩa
전개하다: triển khai phát triển
군인: quân nhân, người thuộc quân đội
회복: hồi phục , khôi phục
진압하다: trấn áp, đàn áp
희생되다: bị hi sinh
충족하다: thỏa mãn
충돌하다: xung đột, va chạm
직선제: chế độ bầu cử trực tiếp
주장하다: chủ trương, khẳng định
시위: biểu tình
확산되다: được mở rộng, được phát triển, lan rộng
개헌: sự sửa đổi hiến pháp
이루어지다: thiết lập, tạo thành, đạt được
국정감사권: quyền thanh tra nhà nước, quyền thanh tra chính phủ
행정부: Chính phủ
견제하다: kìm hãm, cản trở, khống chế
부활하다: hồi sinh
균형: sự cân bằng
정당: chính đảng
이념: tư tưởng
정권: chính quyền
복수정당제: chế độ đa đảng
소속되다: được thuộc về, được trực thuộc