행정기관: cơ quan hành chính
살림살이: cuộc sống sinh hoạt, cuộc sống gia đình
하수도: đường nước thải
교체: sự thay đổi
설치: việc lắp đặt, việc xây dựng
처리하다: xử lý
효율적: tính hiệu suất, tính năng suất 
부서: bộ phận, phòng, ban
포털: cổng thông tin điện tử 
부처: phòng ban chính phủ
연령: độ tuổi 
저렴하다: giá rẻ
보건: bảo vệ sức khỏe, chăm sóc sức khỏe
위생: vệ sinh 
대여하다: cho thuê, cho mượn
답사: việc đi thực tế
조사하다: khảo sát, điều tra
간접적: tính gián tiếp
훨씬: hơn hẳn, rất nhiều
생생하다: sống động, sinh động 
인터뷰하다: phỏng vấn
관찰하다: quan sát
보충하다: bổ sung
유의사항: những điều cần lưu ý
분명히: một cách rõ ràng
치밀하다: chi tiết, tỉ mỉ
답사 보고서 양식: Mẫu báo cáo chuyến đi thực tế
제작: chế tác, sản xuất
홍보: sự quảng bá, thông tin quảng bá
담당직원: nhân viên phụ trách
수첩: sổ tay