첨단산업: công nghiệp hiện đại
넘어서다: vượt qua
경제 불황: suy thoái kinh tế, sự khủng hoảng kinh tế
수출액: kim ngạch xuất khẩu
차지하다: giành, chiếm giữ
평면 TV: TV màn hình phẳng
교역품목: hạng mục thương mại
살펴보다: xem xét. suy xét
석유제품: sản phẩm dầu mỏ
선박: tàu thủy
해양구조물: cấu trúc ngoài khơi, cấu trúc hàng hải
무선통신기기: thiết bị liên lạc không dây
상위를 차지하다: chiếm vị trí cao, chiếm vị thế cao
거두다: thu hoạch, thu gom
더불어: cùng nhau, cùng với, ngoài ra
자유무역협정: hiệp định tự do thương mại (FTA)
발효: phát huy hiệu lực, có hiệu lực
타결되다: được thỏa thuận
관세: thuế quan
자료: tư liệu, dữ liệu
국내총생산: tổng sản phẩm quốc nội
순위: vị trí, thứ bậc
뒤바뀌다: bị đảo ngược
명목: danh nghĩa
선진국: nước phát triển
갖추다: có, trang bị
계기: bước ngoặc, dấu mốc
확대하다: mở rộng
고려하다: căn nhắc, suy tính đến
지속가능한 성장: tăng trưởng bền vững
과제: bài toán
추진하다: xúc tiến, thúc đẩy
아시아유럽정상회의: hội nghị thượng đỉnh Á Âu
아시아-태평양 지역: khu vực châu Á – Thái Bình Dương
회담: hội đàm
대응하다: đối ứng
정상회의: hội nghị thượng đỉnh, hội nghi cấp cao
긴밀히: một cách thân thiết, một cách gắn bó
보답하다: báo đáp, trả ơn
개발원조위원회: ủy ban hỗ trợ phát triển và hợp tác kinh tế
꼽힌다: nằm trong, thuộc vào, được xếp vào
제철소: nhà máy luyện thép
배수로: đường thoát nước
산림 보호: bảo vệ núi rừng
고용하다: thuê lao động, tuyển lao động
수익금: tiền lời
소외계층: tầng lớp người bơ vơ trong xã hội
창업: sáng lập, khởi nghiệp
역량: năng lực, lực lượng
끌어내다: mang ra, lấy ra