맞닿다: tiếp giáp 
면서도: ‘mặc dù...nhưng’
철도: đường sắt, đường ray
항공편: đường hàng không, phương tiện hàng không
고속도: đường cao tốc
지정되다: được chỉ định, được công nhận
피서지: nơi nghỉ mát
지하광물자원: tài nguyên khoáng sản ngầm
석탄: than đá
채굴하다: khai thác mỏ, khai quật
광산산업: công nghiệp khoáng sản
사라지다: biến mất
버려지다: bị vứt bỏ, bị bỏ rơi
폐광: mỏ hoang, mỏ dừng không khai thác khoáng sản nữa
보존하다: bảo tồn 
광부: thợ mỏ
피서: sự tránh nóng, sự nghỉ mát 
펼쳐지다: được trải ra
이름나다: nổi tiếng
해돋이: mặt trời mọc, bình minh 
거듭나다: đổi mới
유일하다: duy nhất
호수: hồ nước 
철쭉: cây Đỗ Quyên 
평야: đồng bằng
논: ruộng, đồng lúa 
밭: vườn, rẫy, cánh đồng
일조량: lượng ánh nắng mặt trời
재배되다: được trồng trọt, được canh tác 
균형: sự cân bằng
이전하다: di dời, chuyển dời
행정: hành chính 
행정부처: văn phòng hành chính chính phủ
총리실: văn phòng thủ tướng
기획재정부: Bộ Chiến lược và Tài chính
공정거래위원회: Ủy ban Thương mại Công bằng 
농림수산식품부: Bộ thực phẩm, Nông - Lâm nghiệp và Thủy sản
국토해양부: Bộ Đất đai, Giao thông và Hàng hải
환경부: Bộ Môi trường
문화체육관광부: Bộ Văn hóa, Thể thao và Du lịch 
지식경제부: Bộ Kinh tế tri thức Hàn Quốc 
보건복지부: Bộ Y tế phúc lợi
국가보훈처: Ban yêu nước và cựu chiến binh
옮기다: chuyển dời
중앙행정부처: văn phòng hành chính trung ương
소속: thuộc về
마무리하다: hoàn tất
위상: vị thế, vị trí
균형: sự cân bằng
이바지하다: cống hiến, đóng góp