태조: Thái tổ, vị vua đầu tiên của triều đại
옮기다: chuyển, dời
사상: tư tưởng, lý tưởng
토대: nền móng, nền tảng, cơ sở
실천하다: thực hiện, đưa vào thực tiễn
신분제: chế độ thân phận, chế độ phân biệt đẳng cấp/ phân biệt giai cấp
양반: lưỡng ban, thượng lưu, quý tộc
중인: giới trung lưu
상민: thường dân
천민: tiện dân, dân đen
다스리다: cai trị, thống trị
신하: hạ thần
정성: sự hết lòng, sự tận tâm
존경하다: tôn kính, kính trọng
신뢰하다: tín nhiệm, tin cậy
의지하다: dựa, tựa vào, nương nhờ vào, nhờ vả vào
여전히: vẫn, vẫn còn như xưa 
문반: Ban văn, hàng ngũ quan văn
무반: Ban võ, hàng ngũ quan võ
근본도리: đạo lý căn bản
강령: phương châm, điều lệ, quy tắc, ý niệm, nguyên tắc cơ bản
인륜: luân lý
삼강: tam cương, 3 mối quan hệ ràng buộc
오륜: ngũ luận, ngũ thường
도리: đạo lý, nghĩa vụ, bổn phận 
의리: đạo nghĩa
순서: thứ tự, tuần tự
훈민정음: Huấn dân chính âm 
자격루: đồng hồ nước 
앙부일구: đồng hồ mặt trời
혼천의: thiên cầu (1 loại dụng cụ quan trắc vị trí và sự vận động trái đất, mặt trời...)
지정되다: được quy định, được chỉ định, được công nhận
세계기록유산: di sản kỉ lục thế giới
천체관측기구: dụng cụ quan trắc thiên thể (vật thể trong vũ trụ)
시각: thời giờ, thời khắc
절기: mùa, sự phân thành tiết khí
더불어: cùng với, cùng nhau
농사짓다: làm nông
정책을 펼치다: mở rộng chính sách
편찬하다: biên soạn
시조: thủy tổ, ông tổ
태조: thái tổ, vị vua đầu tiên của 1 triều đại
방대하다: khổng lồ, to lớn, đồ sộ
조선왕조실록: Triều Tiên Vương Triều Thực Lục, Biên niên sử triều đại Joseon
망라하다: bao gồm tất cả, bao gồm hết thảy
귀중하다: quý giá
신빙성: độ tin cậy, tính chính xác
의의: ý nghĩa
등재되다: được đăng ký
열람하다: tham khảo, tìm hiểu