소비하다: tiêu dùng
전시: triển lãm
취향: khuynh hướng, sở thích
트로트: tình ca, nhạc trữ tình
발라드: ballad
장르: thể loại
장년층: tầng lớp 30 đến 40 tuổi
중년층: tầng lớp trung niên, giới trung niên (40 đến 59 tuổi)
풍: phong cách
청소년: thanh thiếu niên.
청년층: tầng lớp thanh niên
인기를 끌다: được ưa thích, tạo nên cơn sốt, nổi tiếng….
두루: đều khắp
아이돌: idol, thần tượng
등장하다: ra mắt, xuất hiện, lộ diện (sân khấu, kịch, phim…)
즐겨보다: thích xem
아침 연속극: phim truyền hình dài tập chiếu buổi sáng
일일 연속극: phim truyền hình dài tập chiếu mỗi ngày
수목  연속극: phim truyền hình dài tập chiếu cuối tuần
전개: triển khai, tiến hành công việc
오르내리다: lên xuống, tăng giảm, giao động
이른바: sở dĩ gọi là, như người ta thường nói
양궁: bắn cung
거두다: đạt được, giành được
쇼트트랙: môn đua tốc độ trên băng (short track)
스피드 스케이팅: trượt băng tốc độ (speed skating)
프로야구: bóng chày chuyên nghiệp
생중계되다: được phát sóng
못지않다: không thua kém
동호회: hội những người cùng sở thích
확산되다: lan rộng  
응원하다: cổ vũ, động viên
열정적: tính nhiệt tình
막대: gậy, que
풍선: bóng bay
막대 풍선: thanh bóng
머플러: khăn choàng cổ
는 물론: không những mà cả
야광봉: thanh đèn dạ quang
활용하다: vận dụng, ứng dụng, sử dụng
독특하다: đặc sắc, đặc biệt
펼친다: bày ra, tổ chức, mở ra…
개개인: mỗi người, từng người
힘차다: đầy sức lực 
수입하다: du nhập
비중: tỷ trọng
차지하다: chiếm giữ, nắm giữ
수용하다: chứa, tiếp nhận
확산되다: được mở rộng, được phát triển, lan rộng
이어지다: được nối tiếp, được tiếp diễn
넘다: vượt qua
특색: đặc sắc
정서: tình cảm
호소하다: kêu gọi
지니다: gìn giữ, có, mang
주목: sự quan tâm chú ý
본격적: thật sư, chính thức
진출하다: tiến vào, bước vào
단순하다: đơn giản, mộc mạc
경쾌하다: nhẹ nhàng, thoải mái
리듬: nhịp điệu (rhythm)
멜로디: giai điệu (melody)
특징을 띠다: mang đặc trưng
양궁: bắn cung
쇼트트랙: môn đua tốc độ trên băng
정신력: sức mạnh tinh thần
훈련: sự rèn luyện, sự huấn luyện
지도자: người dẫn dắt, người hướng dẫn
영입하다: tuyển chọn
감독: sự giám sát, người giám sát
맡다: đảm nhiệm, đảm trách
가리키다: chỉ
서구: phương tây
장르: thể loại
감수성: sự nhạy cảm
흥미롭다: hứng thú, hứng khởi
가사: lời bài hát
경쟁력: năng lực canh tranh
홍보: quảng bá
비결: bí quyết