분단: sự chia cắt, sự chia tách
지배: sự cai trị, sự thống trị
패하다: bại, thua
벗어나다: thoát khỏi
해방: sự giải phóng
맞이하다: đón, đón tiếp
건설: sự xây dựng
소련군: quân đội Liên Xô
미군: quân đội Mỹ
갈등: sự mâu thuẫn
대립: sự đối lập
수립되다: được thành lập
공격하다: tấn công, công kích
휴전협정: Hiệp định đình chiến
한국전쟁: Chiến tranh Triều Tiên
수백만: hàng triệu
고통: sự thống khổ, sự đau đớn
때로: đôi khi, đôi lúc
교류: sự giao lưu, sự hợp lưu
남북정상회담: Hội nghị thượng đỉnh Nam Bắc, Hội nghị thượng đỉnh Liên Triều
전후하다: khoảng, trước sau, theo sau, được nối tiếp
개선되다: được cải thiện
개성공단: Khu công nghiệp Kaesong
이산가족: gia đình ly tán
극적: kịch tính
통일: thống nhất 
분단되다: bị chia cắt
회담: cuộc hội đàm 
정상 회담: hội nghị thượng đỉnh
국방위원장: Chủ tịch ủy ban quốc phòng
당기다: lôi kéo
선언: sự tuyên bố, sự tuyên ngôn
발표하다: công bố, phát biểu
자주적: tính tự chủ
이산가족: gia đình ly tán
활성화: sự thúc đẩy phát triển
평화번영: hòa bình thịnh vượng
평화롭다: yên bình 
밀접하다: mật thiết, tiếp xúc mật thiết
대륙: đại lục, lục địa
관계를 맺다: thiết lập quan hệ
유교: nho giáo
불교: phật giáo
당시: đương thời, thời đó
성장하다: phát triển, tăng trưởng
개선: sự cải thiện
식민지: thuộc địa
점령하다: chiếm đóng, chiếm lĩnh
부정적: tính tiêu cực
별개: sự khác biệt
우방: nước anh em
복구하다: Khôi phục, hồi phục
재건하다: tái thiết, cải tổ
군사적: tính quân sự
긴밀하다: thân thiết, gắn bó
측면: phương diện
한때: nhất thời
거래: sự giao dịch
활성화되다: trở nên phát triển, trở nên sôi nổi
자원: tài nguyên
영역: lĩnh vực
우호적: tính hữu nghị 
영토: lãnh thổ
어장: ngư trường, bãi cá
형성되다: được hình thành
해저: đáy biển
천연가스: khí ga thiên nhiên
해양심층수: nước tầng biển sâu
개발: sự khai thác
전략적: tính chiến lược
요충지: vùng trọng điểm
제정하다: ban hành, quy định
기재하다: ghi chép
영토분쟁: tranh chấp lãnh thổ
일으키다: gây nên
받아들이다: chấp nhận, tiếp nhận
문헌: tư liệu
지배하다: thống trị
수호: sự gìn giữ
임무를 다다: làm tròn nhiệm vụ, hoàn thành nhiệm vụ