침략을 받다: bị xâm lược
황폐화되다: bị bỏ hoang, bị bỏ phế
커다란: lớn, rất lớn
개혁하다: đổi mới, cải cách
상공업: công thương nghiệp
유학자: học giả Nho giáo
실학: phong trào Thực Học (Phong trào học thuật từ nửa cuối thế kỷ 17 đến cuối thời kì Choson, mong muốn nâng cao đời sống thực tế và cải cách chế độ xã hội)
개선하다: cải tiến, cải thiện
문물: sản vật văn hóa 
도입되다: được đưa vào
나침반: la bàn
천리경: một loại kính viễn vọng của phương Tây
자명종: đồng hồ báo thức
배외정책: chính sách bài ngoại
거중기: máy nâng ròng rọc
다루다: xử lý
일제 강점기: Thời kỳ Nhật chiếm đóng
제국: đế quốc
대한 제국: Đại Hàn Đế Quốc (Tên gọi mới của Joseon được định ra vào năm 1897. Bị diệt vong khi quốc quyền rơi vào tay Nhật Bản năm 1910)
개혁: cải cách, đổi mới
빼앗기다: bị tước đoạt, bị giành lấy
점령하다: chiếm lĩnh, chiếm đóng
강압적: tính độc đoán, tính chuyên chế, tính áp đặt
식민: thực dân
억압하다: áp bức
감옥: nhà tù, nhà giam
가두다: nhôt, giam giữ 
강제: cưỡng chế
심지어: thậm chí, đến nỗi, ngay cả
위안부: phụ nữ mua vui cho bính lính trong chiến tranh
끌려가다: bị giải đi, bị lôi đi
되찾다: tìm lại, giành lại
끊임없이: một cách không ngừng
계기: bước ngoặc, dấu mốc
임시 정부: chính phủ lâm thời 
사형: tử hình, hành hình
간부: lãnh đạo, cán bộ
폭탄: bom
순국하다: hi sinh, tử quốc
무장: sự vũ trang, quân trang
투쟁: sự đấu tranh
무장 투쟁을 벌이다: tiến hành đấu tranh vũ trang
언론: ngôn luận
핍박: sức ép, áp lực
주시경: là một trong những người sáng lập ngôn ngữ học hiện đại của Hàn Quốc. Ông đã cùng các sinh viên của mình giúp chuẩn hóa ngôn ngữ Hàn Quốc.
잃다: đánh mất, mất
건국하다: lập nước
일제강점기: thời kỳ Nhật chiếm đóng
끊임없이: một cách không ngừng
모금: việc quyên góp 
지다: nợ
빚을 갚다: trả nợ
퍼지다: lan rộng
침략: sự xâm lược
맞서다: đối đầu, chiến đấu