처우: sự đãi ngộ, sự đối xử
제정되다: được ban hành, được quy định
불합리하다: bất hợp lý
차별: sự phân biệt, sự kỳ thị
체계적: một cách có hệ thống
명시하다: ghi rõ
근거: cơ sở, căn cứ
침해: sự xâm hại
의하다: dựa vào
한도: giới hạn, hạn độ
민원: dân sự
처리하다: xử lý
고용주가: chủ lao động
대등하다: ngang bằng
정보화: thông tin hóa
단순히: đơn thuần, chỉ là
구성원: thành viên
협의회: buổi thảo luận, cuộc họp
입장: ý kiến, lập trường
효과적: tính hiệu quả
마련하다: chuẩn bị, sắp xếp...
기여하다: đóng góp, góp phần
합동: phối hợp, kết hợp
순찰하다: tuần tra
분쟁: tranh chấp, xung đột
실질적: thiết thực, thực tế
의사소통: sự trao đổi, sự giao tiếp, sự hiểu ý nhau
기여하다: đóng góp, góp phần
국경: biên giới
정착하다: định cư